1111111111111111111111111111111111
1C0001000000000000000000000000E001
1010010100100000101001000000010101
1010010010101010001001000000010101
1P00010000000000000000000000000001
1111111111111111111111111111111111