111111111111111
111111X101XXX11
111PCCCE00X0X11
111111111111111